8 8 4
00011100
00014100
11113100
14235111
11132341
00121111
00141000
00111000