6 8 1
011110
112210
122210
112211
112221
162521
166341
111111
